########################################
#......H..........#....................#
#......H...............................#
#......H..........#....................#
#......H....H..........................#
#.....HH....H..........................#
#.....HH....H..........................#
#.....HH....H..........................#
#....H######H#######H..................#
#....H.H...#H.......H..................#
#^^^.H.H...#H.......H..................#
#.^^.H#H...#HH......H..................#
#..^.H#H...##H......H..................#
#.H..H#H....#H....^.H..................#
#....H#H....#H......H..................#
#.H..H#H....#H......H..................#
#....H#H....#H......H..................#
#^^^.H#H####H.......H..................#
#.H..H#H....#H.....#H..................#
#^^^.H#H....#H.....#H..................#
#..#.H#H...........#H..................#
#..#.H#.........####H..................#
#..##H#^^H^........#H..................#
#^HH.H#..H.........#H..................#
#^HH.H#..H.........#H..................#
#..^.H#######^^^^#^#H..................#
#^...H#............#H....H.............#
#....H#............#H....H.............#
#.P..H#......T...#.#H....H.......T...P.#
########################################