########################################
#......H..........#....................#
#......H...............................#
#......H..........#....................#
#......H....H..........................#
#.....HH....H..........................#
#.....HH....H..........................#
#.....HH....H..........................#
#....H######H#######H..................#
#....H.H...#H.......H..................#
#^^^.H.H...#H.......H..................#
#.^^.H#H...#HH......H..................#
#..^.H#H...##H......H..................#
#.H..H#H....#H....^.H..................#
#..^^^^^^^^^^^^^^^^^^^^^^^^^^#H........#
#.H..........................#H........#
#............................#H........#
#^^..........................#HH.......#
#.H....^^^^^^^^^^^^^^^^^^^^^^#HH.......#
#^^..........................#HH.......#
#............................#HH.......#
#............................#HH.......#
#............................#HH.......#
#^H..........................#HH.......#
#^H..........................#HH.......#
#............................#HH.......#
#^.......................H...#HH.......#
#........................H...#HH.......#
#.P......................H...#HH.#...P.#
########################################