########################################
#......H..........#....................#
#......H...............................#
#......H..........#....................#
#......H....H..........................#
#.....HH....H..........................#
#.....HH....H..........................#
#.....HH....H..........................#
##^^^.H######H#######H..........#^^^...#
##....H.H...#H.......H..........#......#
##^^^.H.H...#H.......H..........#^^^...#
##....H#H...#HH......H..........#......#
##^^^.H#H...##H......H..........#^^^...#
##....H#H....#H....^.H..........#......#
##^^^.H#H....#H......H..........#^^^...#
##....H#H....#H......H..........#......#
##^^^.H#H....#H......H..........#^^^...#
##....H#H####H.......H..........#......#
##^^^.H#H....#H.....#H..........#^^^...#
##....H#H....#H.....#H..........#......#
##^^^.H#H...........#H..........#^^^...#
##....H#.........####H..........#......#
##^^^#H#^^H^........#H..........#^^^...#
##....H#..H.........#H..........#......#
##^^^.H#..H.........#H..........#^^^...#
##....H#######^^^^#^#H..........#......#
##^^^.H#............#H....H.....#^^^...#
##....H#............#H....H.....#......#
##^^^PH#......T...#.#H....H.....#^^^.P.#
########################################